.....B.CCC..DDD
E......F...GGGG
E..HHH.F.......
II..J.....KKK..
.............LL
.M...NOOPP.....
.M...N..QRRRRR.
SSSS....Q......
......T.U.....V
WWWWW.T.U.....V
....X.T........
....X..YZZZ....
.AAAX..Y......0
.B.....Y.......
CCCCCDDDDD.....
