.....B...
CCDD.....
.FFX.GG..
AAAX....0
HH.X.....
III......
J...KLLM.
J....K..M
NN..O..P.
