...B.CCCC
DD...E...
XXX.F....
GGGFF.I..
H.AAA.IJ0
H...KLLJ.
MNNOK....
MPPQRR...
SPTUVVVWW
