...B..CCC..DDD.
EEE..F...GGGG..
HHH..F.........
...I.JJJ...KKK.
...........LLL.
.M...NN...O....
.M..Q....RRRR.S
TTTT...........
...U.V.W.....X.
AAAA.V.W.....X0
....ZV.PPP...X.
....Z...B......
.B.....CCC.....
.DDD...EEE.....
FFFFF.GGGGG....
