......B..
CC.......
EE.FFGGG.
AAA..X..0
I..J.X...
I..J.X...
bb.MMN.O.
KK...N.O.
BRR....O.
