.....B...
CCDD...yy
.FFX.GG..
AAAX..m.0
HH.X..m..
III.hh...
J...KLLM.
J...K..M.
NN..B.PP.
