II.B..CCC..DDD.
EE..F...GGGG...
HH..F..........
.....JJJ...KKK.
...........LLL.
.M...NN...B...S
.M..Q....RRRR.S
.AAAQ...W.....0
.....V..W.....X
YYYY.V..W.....X
....ZV........X
....Z..TTT.....
.BBB...CCC.....
.DDD...EEE.....
FFFFF.GGGGG....
