...B.CCCC
DD...kkk.
XXX.F....
GGG.F.I..
H.AAA.IJ0
H....LLJ.
MNNQ..bb.
MPPQRR...
BP..VVVWW
