hh..B.CCC
.ttt...F.
.AAA.p.F0
EEE..p.F.
G.jjjp.F.
G..bbb...
HHIIIII.J
K.......J
K...LLLLL
