......B..
CC.......
EE.FFGGG.
AAA..X..0
I..J.X...
I..J.X...
KK.MMN.O.
KK..NN.O.
BRR....O.
