AAA...J.0
CC..B.J..
EE.FFFF..
GHHIu.X..
G..Iu.X..
K.LLu.X..
K..MMbbb.
NN..O....
PP..O....
