...B.CCCC
DD.......
XXX.F....
GGG.F.I..
H.AAA.IJ0
H....LLJ.
MNNQB....
MPPQRR...
BP..VVVWW
