AAA...J.0
CC..D.J..
EE.FFFF..
GHHI..X..
G..I..X..
K.LL..X..
K..MM....
NN..O....
PP..O....
