II.B..CCC..DDD.
EE..F...GGGG...
HH..F..........
...I.JJJ...KKK.
...........LLL.
.M...NN...O...P
.M..Q....RRRR.S
.AAAQ...W.....0
...U.V..W.....X
YYYY.V..W.....X
....ZV........X
....Z..TTT.....
.BBB...CCC.....
.DDD...EEE.....
FFFFF.GGGGG....