...B..CCC..DDD.
EEE..F...GGGG..
HHH..F.........
...B.JJJ...KKK.
...........LLL.
.M...NN...B....
.M..QQQ..RRRR..
TTTT...........
...B.V.W.....X.
AAAA.V.W.....X0
....ZV.PPP...X.
....Z...B......
.B...CCCC......
.DDD...EEE.....
FFFFF.GGGGG....
