......B..
CC..D....
EE.FFGGG.
AAA..X..0
I..J.X...
I..J.X...
KKLMMN.O.
KKP.NN.O.
QRR....S.
